#####...#####
.#.#.@#....##
##....##..#.#
##.######...#
##..###...###
###..###.####
....#.#......
#.###.....##.
#..###...##..
##.###..##...
##.....##....