....#######
...#......#
..#.......#
.@........#
.#........#
..#.......#
...########
.....#....#
....#.....#
...#......#
..#.......#